00000000001000|00000000000000000
0*000000001000|00000000000000000
00000000001000|00000000000000000
00#00000001000|00000----H0000000
ppppppHppp11111111110000H0000000
000000H00000000000000000H0000000
000000H00000000000000000H0000000
000000H-----------------H0000000
000000H00000000*00000000H0000B00
000000H00000000000000000H000____
000000H00000000000000000H#000000
1H11111111rrrrrrrrrrr11111111111
0H00000001p000000000b00000000000
0H00000001pp00000000b00000000*00
0H00000W01ppp000R000b0000#000000
11111111111111111111111111111111