000000000000000000000000000|0000
0000000---------------00000|0000
00*000000000000000000000#00|0000
11111110000000000000001111111H11
00000000000000000000000000000H00
000000000000000*0000000000000H00
0W00#0000000000000000000H----H00
111H11100000________0000H0000000
000H00000000000000000000H0000000
000H00000000________0000H0000000
000H00000000000000000000H0000000
111111111H111rrrrrrrrrrrrrrrrrrr
000000000H0000000000000000000000
000000000H000000000000000000*000
000000000H000000R00000#000000000
11111111111111111111111111111111