00000|00000000000000000000000000
00000|000000000000000000000000*0
00000|0000000000000000000W0000#0
11111111100000000000000ggggggHgg
000000000oo000000000000000000H00
00000000000oo0000000000000000H00
0Y000#0B00000oo00000000000000H00
111H11111000000o0000000000000H00
000H000000000000000*000000111111
000H000000000000________00000000
0R0H0000000000000000000000000000
1111111111111111111111111H111111
0000000000000000000000y00H000000
0*00000000000000000000y00H000000
00000000000000W0000#00y00H000Y00
11111111111111111111111111111111